しませんでした	する	POLITE_PAST_NEGATIVE
しましょう	する	POLITE_VOLITIONAL
した	する	PAST
して	する	TE
しろ	する	IMPERATIVE
せず	する	ZU
せよ	する	IMPERATIVE
しすぎる	する	SUGIRU
しちゃう	する	CHAU
しなさい	する	NASAI
しました	する	POLITE_PAST
しません	する	POLITE_NEGATIVE
させる	する	CAUSATIVE
される	する	PASSIVE
しそう	する	SOU
したい	する	TAI
したら	する	TARA
したり	する	TARI
しない	する	NEGATIVE
します	する	POLITE
しよう	する	VOLITIONAL
来すぎる	来る	SUGIRU
来ませんでした	来る	POLITE_PAST_NEGATIVE
来ましょう	来る	POLITE_VOLITIONAL
来ちゃう	来る	CHAU
来なさい	来る	NASAI
来ました	来る	POLITE_PAST
来ません	来る	POLITE_NEGATIVE
来させる	来る	CAUSATIVE
来られる	来る	POTENTIAL_OR_PASSIVE
来そう	来る	SOU
来たい	来る	TAI
来たら	来る	TARA
来たり	来る	TARI
来ます	来る	POLITE
来ない	来る	NEGATIVE
来よう	来る	VOLITIONAL
来れる	来る	POTENTIAL
来た	来る	PAST
来て	来る	TE
来い	来る	IMPERATIVE
来ず	来る	ZU
きすぎる	くる	SUGIRU
きませんでした	くる	POLITE_PAST_NEGATIVE
きましょう	くる	POLITE_VOLITIONAL
きちゃう	くる	CHAU
きなさい	くる	NASAI
きました	くる	POLITE_PAST
きません	くる	POLITE_NEGATIVE
こさせる	くる	CAUSATIVE
こられる	くる	POTENTIAL_OR_PASSIVE
きそう	くる	SOU
きたい	くる	TAI
きたら	くる	TARA
きたり	くる	TARI
きます	くる	POLITE
こない	くる	NEGATIVE
こよう	くる	VOLITIONAL
これる	くる	POTENTIAL
きた	くる	PAST
きて	くる	TE
こい	くる	IMPERATIVE
こず	くる	ZU
いって	く	TE
ゆって	く	TE
行って	く	TE
征って	く	TE
逝って	く	TE
往って	く	TE
いった	く	PAST
ゆった	く	PAST
行った	く	PAST
征った	く	PAST
逝った	く	PAST
往った	く	PAST
いっちゃう	く	CHAU
ゆっちゃう	く	CHAU
行っちゃう	く	CHAU
征っちゃう	く	CHAU
逝っちゃう	く	CHAU
往っちゃう	く	CHAU
いったら	く	TARA
ゆったら	く	TARA
行ったら	く	TARA
征ったら	く	TARA
逝ったら	く	TARA
往ったら	く	TARA
いったり	く	TARI
ゆったり	く	TARI
行ったり	く	TARI
征ったり	く	TARI
逝ったり	く	TARI
往ったり	く	TARI
いきませんでした	く	POLITE_PAST_NEGATIVE
ゆきませんでした	く	POLITE_PAST_NEGATIVE
行きませんでした	く	POLITE_PAST_NEGATIVE
征きませんでした	く	POLITE_PAST_NEGATIVE
逝きませんでした	く	POLITE_PAST_NEGATIVE
往きませんでした	く	POLITE_PAST_NEGATIVE
いきましょう	く	POLITE_VOLITIONAL
ゆきましょう	く	POLITE_VOLITIONAL
行きましょう	く	POLITE_VOLITIONAL
征きましょう	く	POLITE_VOLITIONAL
逝きましょう	く	POLITE_VOLITIONAL
往きましょう	く	POLITE_VOLITIONAL
いけ	く	IMPERATIVE
ゆけ	く	IMPERATIVE
行け	く	IMPERATIVE
征け	く	IMPERATIVE
逝け	く	IMPERATIVE
往け	く	IMPERATIVE
いかず	く	ZU
ゆかず	く	ZU
行かず	く	ZU
征かず	く	ZU
逝かず	く	ZU
往かず	く	ZU
いきすぎる	く	SUGIRU
ゆきすぎる	く	SUGIRU
行きすぎる	く	SUGIRU
征きすぎる	く	SUGIRU
逝きすぎる	く	SUGIRU
往きすぎる	く	SUGIRU
いきなさい	く	NASAI
ゆきなさい	く	NASAI
行きなさい	く	NASAI
征きなさい	く	NASAI
逝きなさい	く	NASAI
往きなさい	く	NASAI
いきました	く	POLITE_PAST
ゆきました	く	POLITE_PAST
行きました	く	POLITE_PAST
征きました	く	POLITE_PAST
逝きました	く	POLITE_PAST
往きました	く	POLITE_PAST
いきません	く	POLITE_NEGATIVE
ゆきません	く	POLITE_NEGATIVE
行きません	く	POLITE_NEGATIVE
征きません	く	POLITE_NEGATIVE
逝きません	く	POLITE_NEGATIVE
往きません	く	POLITE_NEGATIVE
いかせる	く	CAUSATIVE
ゆかせる	く	CAUSATIVE
行かせる	く	CAUSATIVE
征かせる	く	CAUSATIVE
逝かせる	く	CAUSATIVE
往かせる	く	CAUSATIVE
いかれる	く	PASSIVE
ゆかれる	く	PASSIVE
行かれる	く	PASSIVE
征かれる	く	PASSIVE
逝かれる	く	PASSIVE
往かれる	く	PASSIVE
いきそう	く	SOU
ゆきそう	く	SOU
行きそう	く	SOU
征きそう	く	SOU
逝きそう	く	SOU
往きそう	く	SOU
いきたい	く	TAI
ゆきたい	く	TAI
行きたい	く	TAI
征きたい	く	TAI
逝きたい	く	TAI
往きたい	く	TAI
いかない	く	NEGATIVE
ゆかない	く	NEGATIVE
行かない	く	NEGATIVE
征かない	く	NEGATIVE
逝かない	く	NEGATIVE
往かない	く	NEGATIVE
いきます	く	POLITE
ゆきます	く	POLITE
行きます	く	POLITE
征きます	く	POLITE
逝きます	く	POLITE
往きます	く	POLITE
いこう	く	VOLITIONAL
ゆこう	く	VOLITIONAL
行こう	く	VOLITIONAL
征こう	く	VOLITIONAL
逝こう	く	VOLITIONAL
往こう	く	VOLITIONAL
訪うて	う	TE
問うて	う	TE
とうて	う	TE
訪うた	う	PAST
問うた	う	PAST
とうた	う	PAST
乞うて	う	TE
恋うて	う	TE
請うて	う	TE
こうて	う	TE
乞うた	う	PAST
恋うた	う	PAST
請うた	う	PAST
こうた	う	PAST
ません	る	POLITE_NEGATIVE
ました	る	POLITE_PAST
らせる	る	CAUSATIVE
らない	る	NEGATIVE
られる	る	POTENTIAL_OR_PASSIVE
られ	る	POTENTIAL_OR_PASSIVE
たら	る	TARA
たり	る	TARI
そう	る	SOU
たい	る	TAI
ない	る	NEGATIVE
ます	る	POLITE
よう	る	VOLITIONAL
れば	る	BA
ず	る	ZU
て	る	TE
ろ	る	IMPERATIVE
た	る	PAST
ちゃう	る	CHAU
ませんでした	る	POLITE_PAST_NEGATIVE
ましょう	る	POLITE_VOLITIONAL
させる	る	CAUSATIVE
すぎる	る	SUGIRU
なさい	る	NASAI
くありませんでした	い	POLITE_PAST_NEGATIVE
くありません	い	POLITE_NEGATIVE
かったら	い	TARA
かったり	い	TARI
かった	い	PAST
くない	い	NEGATIVE
すぎる	い	SUGIRU
ければ	い	BA
くて	い	TE
そう	い	SOU
く	い	ADV
さ	い	NOUN
いませんでした	う	POLITE_PAST_NEGATIVE
きませんでした	く	POLITE_PAST_NEGATIVE
ぎませんでした	ぐ	POLITE_PAST_NEGATIVE
しませんでした	す	POLITE_PAST_NEGATIVE
ちませんでした	つ	POLITE_PAST_NEGATIVE
にませんでした	ぬ	POLITE_PAST_NEGATIVE
びませんでした	ぶ	POLITE_PAST_NEGATIVE
みませんでした	む	POLITE_PAST_NEGATIVE
りませんでした	る	POLITE_PAST_NEGATIVE
いましょう	う	POLITE_VOLITIONAL
きましょう	く	POLITE_VOLITIONAL
ぎましょう	ぐ	POLITE_VOLITIONAL
しましょう	す	POLITE_VOLITIONAL
ちましょう	つ	POLITE_VOLITIONAL
にましょう	ぬ	POLITE_VOLITIONAL
びましょう	ぶ	POLITE_VOLITIONAL
みましょう	む	POLITE_VOLITIONAL
りましょう	る	POLITE_VOLITIONAL
いじゃう	ぐ	CHAU
いすぎる	う	SUGIRU
いちゃう	く	CHAU
いなさい	う	NASAI
いました	う	POLITE_PAST
いません	う	POLITE_NEGATIVE
きすぎる	く	SUGIRU
ぎすぎる	ぐ	SUGIRU
きなさい	く	NASAI
ぎなさい	ぐ	NASAI
きました	く	POLITE_PAST
ぎました	ぐ	POLITE_PAST
きません	く	POLITE_NEGATIVE
ぎません	ぐ	POLITE_NEGATIVE
しすぎる	す	SUGIRU
しちゃう	す	CHAU
しなさい	す	NASAI
しました	す	POLITE_PAST
しません	す	POLITE_NEGATIVE
ちすぎる	つ	SUGIRU
ちなさい	つ	NASAI
ちました	つ	POLITE_PAST
ちません	つ	POLITE_NEGATIVE
っちゃう	う	CHAU
っちゃう	つ	CHAU
っちゃう	る	CHAU
にすぎる	ぬ	SUGIRU
になさい	ぬ	NASAI
にました	ぬ	POLITE_PAST
にません	ぬ	POLITE_NEGATIVE
びすぎる	ぶ	SUGIRU
びなさい	ぶ	NASAI
びました	ぶ	POLITE_PAST
びません	ぶ	POLITE_NEGATIVE
みすぎる	む	SUGIRU
みなさい	む	NASAI
みました	む	POLITE_PAST
みません	む	POLITE_NEGATIVE
りすぎる	る	SUGIRU
りなさい	る	NASAI
りました	る	POLITE_PAST
りません	る	POLITE_NEGATIVE
んじゃう	ぬ	CHAU
んじゃう	ぶ	CHAU
んじゃう	む	CHAU
いそう	う	SOU
いたい	う	TAI
いたら	く	TARA
いだら	ぐ	TARA
いたり	く	TARI
いだり	ぐ	TARI
います	う	POLITE
かせる	く	CAUSATIVE
がせる	ぐ	CAUSATIVE
かない	く	NEGATIVE
がない	ぐ	NEGATIVE
かれる	く	PASSIVE
がれる	ぐ	PASSIVE
きそう	く	SOU
ぎそう	ぐ	SOU
きたい	く	TAI
ぎたい	ぐ	TAI
きます	く	POLITE
ぎます	ぐ	POLITE
させる	す	CAUSATIVE
さない	す	NEGATIVE
される	す	PASSIVE_OR_CAUSATIVE
しそう	す	SOU
したい	す	TAI
したら	す	TARA
したり	す	TARI
します	す	POLITE
たせる	つ	CAUSATIVE
たない	つ	NEGATIVE
たれる	つ	PASSIVE
ちそう	つ	SOU
ちたい	つ	TAI
ちます	つ	POLITE
ったら	う	TARA
ったら	つ	TARA
ったら	る	TARA
ったり	う	TARI
ったり	つ	TARI
ったり	る	TARI
なせる	ぬ	CAUSATIVE
なない	ぬ	NEGATIVE
なれる	ぬ	PASSIVE
にそう	ぬ	SOU
にたい	ぬ	TAI
にます	ぬ	POLITE
ばせる	ぶ	CAUSATIVE
ばない	ぶ	NEGATIVE
ばれる	ぶ	PASSIVE
びそう	ぶ	SOU
びたい	ぶ	TAI
びます	ぶ	POLITE
ませる	む	CAUSATIVE
まない	む	NEGATIVE
まれる	む	PASSIVE
みそう	む	SOU
みたい	む	TAI
みます	む	POLITE
りそう	る	SOU
りたい	る	TAI
ります	る	POLITE
わせる	う	CAUSATIVE
わない	う	NEGATIVE
われる	う	PASSIVE
んだら	ぬ	TARA
んだら	ぶ	TARA
んだら	む	TARA
んだり	ぬ	TARI
んだり	ぶ	TARI
んだり	む	TARI
いた	く	PAST
いだ	ぐ	PAST
いて	く	TE
いで	ぐ	TE
えば	う	BA
える	う	POTENTIAL
おう	う	VOLITIONAL
かず	く	ZU
がず	ぐ	ZU
けば	く	BA
げば	ぐ	BA
ける	く	POTENTIAL
げる	ぐ	POTENTIAL
こう	く	VOLITIONAL
ごう	ぐ	VOLITIONAL
さず	す	ZU
した	す	PAST
して	す	TE
せば	す	BA
せる	す	POTENTIAL
そう	す	VOLITIONAL
たず	つ	ZU
った	う	PAST
った	つ	PAST
った	る	PAST
って	う	TE
って	つ	TE
って	る	TE
てば	つ	BA
てる	つ	POTENTIAL
とう	つ	VOLITIONAL
なず	ぬ	ZU
ねば	ぬ	BA
ねる	ぬ	POTENTIAL
のう	ぬ	VOLITIONAL
ばず	ぶ	ZU
べば	ぶ	BA
べる	ぶ	POTENTIAL
ぼう	ぶ	VOLITIONAL
まず	む	ZU
めば	む	BA
める	む	POTENTIAL
もう	む	VOLITIONAL
らず	る	ZU
れば	る	BA
れる	る	POTENTIAL
ろう	る	VOLITIONAL
わず	う	ZU
んだ	ぬ	PAST
んだ	ぶ	PAST
んだ	む	PAST
んで	ぬ	TE
んで	ぶ	TE
んで	む	TE
い	いる	MASU_STEM
い	う	MASU_STEM
え	う	IMPERATIVE
え	える	MASU_STEM
き	きる	MASU_STEM
き	く	MASU_STEM
ぎ	ぎる	MASU_STEM
ぎ	ぐ	MASU_STEM
け	く	IMPERATIVE
け	ける	MASU_STEM
げ	ぐ	IMPERATIVE
げ	げる	MASU_STEM
し	す	MASU_STEM
じ	じる	MASU_STEM
せ	す	IMPERATIVE
せ	せる	MASU_STEM
ぜ	ぜる	MASU_STEM
ち	ちる	MASU_STEM
ち	つ	MASU_STEM
て	つ	IMPERATIVE
て	てる	MASU_STEM
で	でる	MASU_STEM
に	にる	MASU_STEM
に	ぬ	MASU_STEM
ね	ぬ	IMPERATIVE
ね	ねる	MASU_STEM
ひ	ひる	MASU_STEM
び	びる	MASU_STEM
び	ぶ	MASU_STEM
へ	へる	MASU_STEM
べ	ぶ	IMPERATIVE
べ	べる	MASU_STEM
み	みる	MASU_STEM
み	む	MASU_STEM
め	む	IMPERATIVE
め	める	MASU_STEM
り	りる	MASU_STEM
り	る	MASU_STEM
れ	る	IMPERATIVE
れ	れる	MASU_STEM
れ	れる	MASU_STEM
らせる	る	CAUSATIVE
らない	る	NEGATIVE
られる	る	POTENTIAL_OR_PASSIVE
られ	る	POTENTIAL_OR_PASSIVE
れば	る	BA
